12 12 12 12 12 12 12 12 12 12 12 12 12 12 12 12 12 12 12 12 12 12 12 12 12 12 12 12 12 12 12 12 12 12 12 12 12 12 12 12 12 12 12 12 12 12 12 12 12 12 12 12 12 12 12 12 12 12 12 12 12 12 12 12 12 12 12 12 12 12 12 12 12 12 12 12 12 12 12 12 12 12 12 12 12 12 12 12 12 12 12 12 12 12 12 12
12 12 12 12 12 12 12 12 12 12 12 12 12 12 12 12 12 12 12 12 12 12 12 21 19 19 19 22 12 12 12 12 12 12 12 21 19 19 22 12 12 12 12 12 12 12 12 12 12 12 12 12 12 12 12 12 12 12 12 12 12 12 12 12 12 12 12 12 12 12 12 12 12 12 12 12 12 12 12 12 12 12 12 12 12 12 12 12 12 12 12 12 12 12 12 12 12
12 12 12 12 12 12 12 12 21 19 19 19 22 12 12 12 12 12 12 12 12 21 19 20 34 34 34 18 19 19 19 19 22 12 12 17 0 0 16 12 12 12 21 19 19 19 19 19 22 12 12 12 12 12 12 12 12 12 12 12 12 12 12 12 12 12 12 12 12 12 12 12 12 21 19 19 22 12 12 12 12 12 12 12 12 12 21 19 19 19 19 22 12 12 12 12 12 12 12
12 12 12 12 12 12 21 19 20 34 34 34 18 19 22 12 12 12 12 12 12 17 34 34 34 3 2 34 34 34 34 34 16 12 12 17 34 34 16 12 12 12 17 34 34 34 1 34 18 19 19 19 22 12 12 12 12 12 21 19 22 12 12 12 12 12 12 21 19 19 19 22 12 17 0 0 16 12 12 12 12 12 12 12 21 19 20 34 1 3 34 16 12 12 12 12 12
12 12 12 21 19 19 20 34 34 34 34 34 34 3 16 12 12 12 12 12 12 17 34 0 0 0 1 0 1 0 1 34 18 19 19 20 34 34 18 19 19 19 20 34 0 0 0 0 0 34 34 34 18 19 19 19 19 19 20 0 18 19 19 22 12 12 12 17 34 34 0 18 19 20 2 0 18 19 19 19 19 19 19 19 20 3 1 0 2 34 34 16 12 12 12 12 12
12 12 12 17 2 1 34 34 0 0 3 0 0 2 18 19 19 22 12 12 12 17 0 0 34 34 0 0 0 2 0 0 0 0 34 34 34 34 34 34 34 34 34 34 34 34 34 34 34 34 34 0 34 34 0 0 34 0 34 0 34 34 34 18 19 19 19 20 1 34 34 34 34 34 34 34 0 34 34 34 0 0 0 34 34 1 34 2 0 34 34 18 22 12 12 12
12 12 12 17 1 34 3 34 0 34 1 0 34 34 0 1 34 16 12 12 12 17 0 0 0 1 0 0 0 2 0 0 3 0 0 0 1 0 0 1 0 1 0 0 0 0 0 0 1 0 2 34 34 34 0 34 34 34 0 0 0 0 0 34 34 34 34 34 34 34 34 34 0 1 1 0 0 0 34 34 0 1 0 0 1 0 3 34 34 34 1 34 16 12 12 12
12 21 19 20 34 34 34 0 0 0 0 0 2 1 0 0 0 18 19 19 19 20 0 3 0 0 0 0 2 0 1 3 0 0 1 0 2 0 0 0 2 0 3 0 0 0 0 3 0 0 2 0 0 0 2 0 0 0 0 0 0 3 0 0 0 0 0 0 0 0 0 0 3 0 0 0 0 0 3 0 0 1 0 0 0 0 0 2 0 34 34 13 24 12 12 12
21 20 34 1 2 34 1 34 0 0 3 0 0 0 2 0 1 0 0 0 1 0 0 0 0 0 0 1 2 0 1 1 0 0 2 0 0 1 0 2 0 1 0 1 0 0 2 0 0 3 0 0 0 0 3 0 1 0 1 0 3 0 0 2 0 0 0 2 0 0 2 0 2 0 0 0 0 1 0 0 0 0 0 0 0 2 0 0 0 34 34 18 22 12 12 12
17 2 0 3 34 0 34 0 2 0 0 0 0 0 0 1 0 0 0 3 0 0 0 0 0 0 1 0 0 2 0 0 3 0 1 0 2 0 0 1 0 0 0 0 3 0 2 0 0 0 0 0 1 0 0 0 0 0 0 0 1 0 0 0 0 0 0 0 0 0 0 0 0 0 0 1 0 0 0 0 0 0 0 0 0 0 0 1 0 34 34 2 16 12 12 12
23 15 0 2 0 34 1 3 0 0 0 0 1 0 3 0 2 0 0 0 1 0 1 0 0 3 0 0 0 1 0 0 0 3 0 0 0 0 2 0 1 0 2 0 0 0 0 0 1 0 0 0 3 0 0 2 0 2 0 0 3 0 0 0 0 3 0 0 1 0 0 0 0 1 0 0 0 1 0 0 2 0 0 0 0 0 2 0 0 2 34 34 16 12 12 12
12 17 1 34 0 3 34 0 2 0 1 4 5 5 5 5 5 5 5 5 5 5 5 5 5 5 5 5 5 5 5 5 5 5 5 5 5 5 5 5 5 5 5 5 5 5 5 5 5 5 5 5 5 5 5 5 5 5 5 5 5 5 5 5 5 5 5 5 5 5 5 5 6 0 0 0 0 0 0 0 0 0 1 0 1 0 0 0 34 34 2 0 16 12 12 12
12 23 14 15 1 34 2 0 0 0 0 7 35 10 10 10 10 10 10 10 10 10 10 10 10 36 35 10 10 10 10 10 10 10 10 10 10 10 10 10 10 10 10 10 10 10 10 10 10 10 10 10 10 10 10 10 10 10 10 10 10 10 10 10 10 10 10 10 10 10 10 36 8 2 0 1 0 0 3 0 2 0 1 0 3 0 1 0 34 34 2 13 24 12 12 12
12 12 12 23 15 34 0 2 0 3 0 7 8 0 0 3 0 0 0 0 0 0 0 0 0 7 8 0 0 0 0 0 0 0 0 0 0 0 0 0 0 0 0 0 0 3 0 0 0 0 0 0 0 0 0 0 3 0 0 0 0 0 0 0 0 0 0 0 0 0 0 7 8 0 0 0 0 0 0 0 0 0 0 0 1 0 1 0 0 34 34 16 12 12 12 12
12 12 12 12 17 2 34 0 1 0 0 7 8 0 2 0 0 3 0 0 0 1 0 0 0 7 8 0 0 0 0 0 0 0 0 0 0 0 0 0 0 0 0 0 3 0 0 0 0 0 0 0 0 0 0 0 0 0 0 0 0 0 0 0 0 0 0 0 1 0 1 7 8 0 0 0 0 0 0 0 0 0 0 3 0 0 2 0 0 1 34 16 12 12 12 12
12 12 12 12 23 15 34 0 0 0 2 7 8 0 2 1 0 0 2 0 0 0 0 0 0 7 8 0 0 0 0 0 0 0 0 0 0 0 0 0 0 0 0 0 0 0 0 0 0 0 0 0 0 0 0 0 0 0 1 0 0 0 0 0 0 0 0 0 0 1 0 7 8 0 0 0 0 1 0 0 0 1 0 0 0 3 0 0 1 34 34 16 12 12 12 12
12 12 12 12 12 17 2 34 0 0 0 7 8 0 0 3 0 0 0 0 0 0 0 0 0 7 8 2 0 0 0 0 0 0 0 0 0 0 0 0 0 0 0 0 0 0 0 0 0 0 0 0 0 0 0 0 0 0 0 0 0 0 0 0 0 0 0 0 0 0 0 7 8 1 0 0 0 0 0 0 0 0 1 0 2 0 2 0 34 34 13 24 12 12 12 12
12 12 12 12 12 17 34 0 0 0 0 7 8 0 0 0 0 0 0 0 0 1 0 0 0 7 8 0 0 0 0 0 0 0 0 0 0 1 0 0 0 0 0 0 0 0 0 0 0 0 0 0 0 0 0 0 0 0 0 0 0 0 1 0 0 0 0 0 0 0 0 7 8 0 0 0 0 0 0 0 0 1 0 2 0 34 34 34 34 2 16 12 12 12 12
12 12 12 12 12 23 15 34 34 0 1 7 8 0 0 0 1 0 0 0 0 0 0 0 0 7 8 0 0 0 0 0 0 0 1 0 0 0 0 0 3 0 0 0 0 0 1 0 0 0 0 0 0 0 0 0 0 0 0 0 0 0 1 0 0 0 0 0 0 0 0 7 8 0 0 0 0 0 0 0 0 0 34 13 14 14 14 14 14 14 24 12 12 12 12 12
12 12 12 12 12 12 17 34 0 34 0 7 8 0 0 0 0 0 0 0 0 0 0 0 0 7 8 0 0 0 0 0 0 0 0 0 0 0 0 0 0 0 0 3 1 0 0 0 0 0 0 0 0 0 3 0 0 0 0 1 0 0 0 0 0 0 0 0 0 0 0 7 8 0 0 0 0 0 0 0 0 0 34 16 12 12 12 12 12 12 12 12 12 12 12 12
12 12 12 12 12 12 17 34 1 34 1 7 8 0 0 0 0 0 0 0 0 0 0 0 0 7 8 0 0 1 1 0 0 2 0 0 0 0 0 0 0 0 1 0 0 0 0 0 0 0 0 0 0 0 0 0 0 0 0 0 0 0 0 0 0 0 0 0 0 0 0 7 8 0 0 0 0 0 0 0 0 0 34 18 19 22 12 12 12 12 12 12 12 12 12 12
12 12 12 12 12 12 17 34 2 34 0 7 8 0 0 0 0 0 0 2 0 0 0 0 0 7 8 1 0 0 0 0 0 0 2 0 0 0 1 0 0 0 0 0 0 0 0 1 0 0 0 0 0 0 0 0 0 0 0 0 0 0 0 0 0 0 0 0 0 0 0 7 8 0 0 0 0 0 0 0 0 0 0 34 34 18 19 19 19 22 12 12 12 12 12 12
12 12 12 21 19 19 20 34 34 34 1 7 8 3 0 0 0 2 1 0 0 0 0 0 0 7 8 0 0 0 0 0 0 0 0 0 0 0 0 0 0 0 0 0 0 0 0 0 0 0 0 0 0 0 0 0 0 0 0 0 0 0 0 0 0 0 1 0 0 0 0 7 8 0 0 0 0 0 0 0 0 0 0 0 0 0 0 34 34 16 12 12 12 12 12 12
12 12 12 17 2 1 34 0 0 34 3 7 8 2 0 0 0 0 0 0 0 0 0 0 0 7 8 0 0 0 0 0 0 0 0 0 0 0 0 0 0 0 0 0 0 0 0 0 0 0 3 0 0 0 3 0 0 0 0 0 0 0 0 0 0 0 0 0 0 0 0 7 8 0 0 0 0 0 0 0 0 0 3 1 0 0 0 0 34 18 19 22 12 12 12 12
12 12 12 17 0 34 0 34 34 0 1 7 8 0 0 1 0 0 0 0 0 0 0 0 0 7 8 0 0 0 0 0 0 0 0 0 0 0 0 0 0 0 0 0 0 0 0 0 0 0 0 0 0 0 0 0 0 3 0 0 0 0 0 0 0 0 0 0 0 0 0 7 8 1 0 0 0 0 0 0 0 0 1 0 0 1 0 0 0 34 34 16 12 12 12 12
12 21 19 20 0 34 0 34 0 0 0 7 8 1 0 0 0 0 0 0 0 0 0 3 0 7 8 2 0 0 0 0 0 0 0 0 0 0 0 0 0 0 3 0 0 0 0 0 0 3 0 0 0 0 0 0 0 0 0 0 0 0 0 0 0 0 0 0 0 0 0 7 8 1 0 0 0 0 0 0 0 0 0 0 0 0 2 0 1 0 34 18 19 22 12 12
21 20 0 1 2 0 1 34 0 34 3 7 8 2 0 0 1 0 0 0 1 0 0 0 0 7 8 1 0 0 0 0 0 0 0 0 0 0 0 0 0 0 0 0 0 0 0 0 0 0 0 0 0 0 0 0 0 0 0 0 0 0 0 0 0 0 0 3 0 0 0 7 8 1 0 0 0 0 0 0 0 0 0 2 0 2 0 0 3 0 0 1 34 16 12 12
17 2 0 3 0 0 0 34 2 0 34 7 8 0 0 1 0 0 0 3 0 0 0 0 0 7 8 3 0 0 0 0 0 0 0 0 2 0 0 0 0 0 0 3 0 0 0 0 0 0 0 0 0 0 0 0 0 0 0 0 0 0 0 0 0 0 0 0 0 0 0 7 8 0 0 0 0 0 0 0 0 0 0 1 0 0 0 0 0 2 0 0 34 16 12 12
23 15 0 2 34 0 1 3 0 34 0 7 8 1 3 0 2 0 0 0 1 0 0 0 1 7 8 0 0 0 0 0 0 0 0 0 3 0 0 0 0 0 0 0 0 0 0 0 0 1 1 0 0 1 0 0 0 0 0 0 1 3 0 0 0 0 0 0 0 0 0 7 8 2 0 0 0 0 0 0 0 1 0 0 1 0 0 3 0 0 0 34 13 24 12 12
12 17 1 0 34 3 0 34 2 34 1 7 8 1 0 0 0 2 0 0 0 0 0 0 0 7 8 0 0 0 0 0 0 0 0 0 0 0 0 0 0 0 0 0 0 0 0 0 0 0 0 1 0 0 0 0 0 0 0 0 0 0 0 0 0 0 0 0 0 0 0 7 8 1 0 0 0 0 0 0 0 0 0 0 3 0 1 0 0 2 34 13 24 12 12 12
12 23 14 15 1 34 2 0 0 34 0 7 8 2 0 0 0 0 1 0 2 0 1 0 0 7 8 0 0 0 0 0 0 0 0 0 0 0 0 0 0 0 0 0 0 0 0 0 0 0 0 0 0 0 0 0 0 0 0 0 0 0 0 0 0 0 3 0 0 0 0 7 8 3 0 0 0 0 0 0 0 0 0 2 0 0 0 0 0 0 34 16 12 12 12 12
12 12 12 23 15 0 34 2 34 3 0 7 8 0 0 3 0 0 0 0 0 0 0 2 0 7 8 0 0 0 0 0 0 0 0 1 0 0 0 0 0 0 0 0 0 0 0 0 0 0 1 0 0 0 1 0 0 0 0 0 0 0 0 0 0 0 0 0 0 0 0 7 8 0 0 0 0 0 0 0 0 0 2 0 0 0 2 0 1 0 34 16 12 12 12 12
12 12 12 12 17 2 0 34 1 0 34 7 8 0 2 0 0 3 0 0 0 1 0 1 0 7 8 0 0 0 0 0 0 0 0 0 0 0 0 1 0 0 0 2 0 0 0 0 0 0 0 0 0 0 0 0 0 0 0 0 0 0 0 0 0 0 0 0 0 0 0 7 8 0 0 0 0 0 0 0 0 0 0 0 0 0 0 1 34 13 14 24 12 12 12 12
12 12 12 12 23 15 0 0 0 34 34 7 8 2 1 0 0 2 0 0 0 0 1 0 0 7 8 0 1 0 0 0 0 0 0 0 0 0 0 0 0 2 0 0 0 0 0 0 0 0 0 0 0 0 0 0 0 0 0 0 0 3 0 0 0 0 0 1 0 0 0 7 8 0 0 0 0 0 0 0 0 0 0 2 0 1 0 34 1 16 12 12 12 12 12 12
12 12 12 12 12 17 2 34 0 0 1 7 8 0 0 3 0 0 0 0 0 0 3 0 0 7 8 2 0 0 0 0 3 0 0 0 0 0 0 0 0 0 0 0 0 0 0 0 0 0 0 3 0 0 0 0 0 0 0 0 0 0 0 0 0 0 0 0 0 0 0 7 8 3 0 0 0 0 0 0 0 0 0 3 0 0 1 0 34 16 12 12 12 12 12
12 12 12 12 12 17 34 0 0 0 0 7 8 0 0 0 0 0 0 0 0 1 0 0 0 7 8 0 0 0 0 0 0 0 0 0 0 0 0 0 0 0 0 0 0 0 0 0 0 0 0 0 1 0 0 0 0 0 0 3 0 0 0 0 0 0 0 0 0 1 0 7 8 2 0 0 0 0 0 0 0 0 0 0 0 0 0 0 34 18 19 22 12 12 12
12 12 12 12 12 23 14 15 0 34 0 7 8 0 0 0 0 2 0 0 0 0 0 0 0 7 8 0 0 0 0 0 0 0 0 0 0 0 0 0 0 0 0 0 0 0 0 0 0 0 0 0 0 0 0 0 0 0 0 0 0 0 0 0 0 0 0 0 0 0 0 7 8 1 0 0 0 0 0 0 0 0 0 0 2 0 0 0 0 0 34 16 12 12 12 12
12 12 12 12 12 12 12 17 34 0 0 7 8 0 0 0 0 0 2 0 0 0 0 0 0 7 8 0 0 0 0 0 0 0 0 0 0 0 0 0 0 0 0 0 0 0 0 0 0 0 0 0 0 0 0 0 0 0 3 0 0 0 0 0 0 0 1 0 0 0 0 7 8 3 0 0 0 0 0 0 0 0 2 0 0 0 3 0 34 13 14 24 12 12 12 12
12 12 12 12 12 12 12 17 0 34 0 7 8 0 0 0 0 0 0 0 0 1 0 0 0 7 8 0 0 0 0 0 0 0 0 0 0 0 0 0 0 0 0 0 0 0 0 0 0 0 0 0 0 0 0 0 0 0 0 0 0 0 0 0 0 0 0 0 0 3 0 7 8 1 0 0 0 0 0 0 0 0 0 0 1 0 34 3 34 18 19 22 12 12 12 12
12 12 12 12 12 12 21 20 34 0 0 7 8 0 0 0 0 0 1 0 2 0 0 0 1 7 8 0 0 0 0 0 0 0 0 0 0 0 0 0 0 1 0 0 0 0 0 0 0 0 0 0 0 0 0 0 0 0 0 0 0 0 0 0 0 0 0 0 0 0 0 7 8 0 0 0 3 3 0 0 3 1 0 3 0 0 1 34 34 34 16 12 12 12 12
12 12 12 21 19 19 20 34 34 0 0 7 8 3 0 0 0 0 0 0 0 0 0 0 0 7 8 0 0 0 0 0 0 0 0 0 0 0 0 0 0 0 0 0 0 0 0 0 0 0 0 0 0 0 0 0 0 0 0 0 0 3 0 0 0 0 0 0 0 0 0 7 8 0 0 3 0 2 0 0 0 0 2 0 1 0 0 3 34 1 34 16 12 12 12 12 12 12
12 12 12 17 2 1 34 34 0 0 3 7 37 5 5 5 5 5 5 5 5 5 5 5 5 38 37 5 5 5 5 5 5 5 5 5 5 5 5 5 5 5 5 5 5 5 5 5 5 5 5 5 5 5 5 5 5 5 5 5 5 5 5 5 5 5 5 5 5 5 5 38 8 0 0 1 0 0 2 0 1 0 0 2 0 0 3 0 1 34 34 16 12 12 12 12
12 12 12 17 34 34 0 3 0 0 1 9 10 10 10 10 10 10 10 10 10 10 10 10 10 10 10 10 10 10 10 10 10 10 10 10 10 10 10 10 10 10 10 10 10 10 10 10 10 10 10 10 10 10 10 10 10 10 10 10 10 10 10 10 10 10 10 10 10 10 10 10 11 2 0 0 1 1 0 3 1 0 3 0 1 0 2 34 34 34 34 16 12 12 12 12
12 21 19 20 34 0 3 0 0 2 0 0 0 1 0 0 0 0 0 0 0 0 0 3 0 0 0 1 0 2 0 0 3 0 0 3 0 0 0 1 0 0 3 0 0 0 1 1 0 0 0 2 0 0 2 0 0 0 3 0 0 2 0 0 0 3 0 0 0 0 0 3 0 0 1 0 0 1 0 3 0 0 0 0 0 0 0 0 0 0 34 16 12 12 12 12
21 20 34 1 2 34 1 0 34 0 3 0 34 34 0 0 1 34 0 0 1 34 34 34 34 34 2 34 34 34 0 2 34 34 34 34 34 2 3 34 34 34 3 34 34 3 34 34 2 34 34 34 34 34 34 34 2 34 34 34 34 34 34 1 1 34 3 34 34 0 1 34 34 34 34 2 34 2 34 34 34 0 0 34 1 34 1 34 34 34 34 16 12 12 12 12
17 2 0 3 0 0 34 34 2 34 34 34 0 0 34 1 34 34 34 3 34 0 34 34 1 34 1 34 34 34 0 34 34 34 0 0 2 0 0 2 34 0 3 0 34 0 34 34 0 34 34 0 0 34 34 34 2 34 0 3 34 1 0 0 3 0 1 0 34 34 0 0 34 0 34 34 34 34 0 0 34 0 0 3 0 34 34 0 2 0 34 16 12 12 12 12
23 15 34 2 34 0 1 3 0 0 0 0 1 0 3 34 2 34 0 34 1 0 3 0 0 1 0 2 0 34 34 0 34 0 1 0 2 0 34 34 0 1 0 0 34 0 34 0 1 34 0 0 0 0 3 34 0 0 0 34 0 1 0 2 34 0 0 0 34 1 0 2 0 0 2 0 3 34 34 34 0 34 0 0 0 34 1 2 0 3 34 16 12 12 12 12
12 17 1 0 13 14 14 14 14 14 14 14 14 14 14 14 14 14 14 14 14 14 14 14 14 14 14 14 14 14 14 14 14 14 14 14 14 14 14 14 14 14 14 14 14 14 14 14 14 14 14 14 14 14 14 14 14 14 14 14 14 14 14 14 14 14 14 14 14 14 14 14 14 14 14 14 14 14 14 14 14 14 14 14 14 14 14 14 14 14 14 24 12 12 12 12
12 23 14 14 24 12 12 12 12 12 12 12 12 12 12 12 12 12 12 12 12 12 12 12 12 12 12 12 12 12 12 12 12 12 12 12 12 12 12 12 12 12 12 12 12 12 12 12 12 12 12 12 12 12 12 12 12 12 12 12 12 12 12 12 12 12 12 12 12 12 12 12 12 12 12 12 12 12 12 12 12 12 12 12 12 12 12 12 12 12 12 12 12 12 12 12
12 12 12 12 12 12 12 12 12 12 12 12 12 12 12 12 12 12 12 12 12 12 12 12 12 12 12 12 12 12 12 12 12 12 12 12 12 12 12 12 12 12 12 12 12 12 12 12 12 12 12 12 12 12 12 12 12 12 12 12 12 12 12 12 12 12 12 12 12 12 12 12 12 12 12 12 12 12 12 12 12 12 12 12 12 12 12 12 12 12 12 12 12 12 12 12